11111111111
1P0000000E1
10110001101
10100000101
100D0100001
10001110001
100001FS001
10100000101
10110001101
10000C00001
11111111111